 ######### 
 #.......# 
##b#####.# 
#..#...#m# 
#....p.#m# 
##b##.##m##
 #........#
 #b####...#
 #......###
 ########  
Solution:
DULLRURUURDL