########
#m.##.m#
#...b..#
#..bb.p#
#..b...#
#m.##.m#
########
        
Solution:
DULLDDUURDR