######  
#....###
#.##bb.#
#.#..#.#
#....#.#
#m#....#
#m.p####
#####   
Solution:
DULLDULRR