     #######
     #..#..#
######.....#
#....#..#..#
#.......#m##
##b######m##
#...b..p...#
#...####...#
#####..#####
Solution:
DULLDDRRUDRR